Muhammed Saudagar -- D BOTTLE Trade
D CAPSULE FORM --  Valerie Court
Valetta Road --  Micheldever Road
Moat Court --  Jolliffe Road
Melton Avenue --  The Anchor
Norwood Road --  Regency Court
Teignmouth Road --  Grange Road
A v B -- A v B
A v B -- A Local Authority v X
A Local Authority v X -- AA  UKUT
AB R on the application of v Secretary of State for Justice -- ABDURRAHMAN TEKIN v
ABDURZAKOVA AND ABDURZAKOV -- Accident Angels UK
Accident Assistance Ltd -- Adams ta Windows
Adams v TH -- Advanced Scaffolding Bristol
Advanced Technology College -- AG v Arthur -Sep-
AG v Arthur and -- AG v Ferguson 
AG v Ferguson  -- AG v Marrett  JRC 
AG v Marrett  JRC  -- AG v Swinburne 
AG v Swinburne and -- AG -v- King  JRC 
AG -v- King  JRC  -- AG v Wilkie
AG v Wilkinson -- Ahmad Ors
Ahmad Aka Munir -- AIR-FLOW Trade Mark
Airhelp Air transport -- AKTAN v TURKEY
AKTAR v TURKEY -- Alcohol Countermeasure Systems
Alcon Inc v -- Alexander Hamilton of
Alexander Hamilton v -- ALI ESEN v
Ali v Esure -- Allen Carrs Easyway International
Allen Carrs Easyway International -- Al-Saadoon Ors
Al-Saadoon Ors -- Amen Corner v
Amending General Order -- Anatoliy Vladimirovich PONOMARYOV and Others v Bulgaria -  
Anatoliy Vladimirovich PONOMARYOV and Others v Bulgaria -   -- ANDREW FRANCIS CLEARY
ANDREW FRASER JOHNSTONE -- Angard Staffing Solutions
Ange Serrano -- ANT v TURKEY
Anta China v -- Apelogun-Gabriels v Lambeth Ors 
Apelogun-Gabriels v Lambeth Ors  -- Arab Republic Of Egypt Embassy
Arab Republic Of Egypt v -- Ariel -v- Halabi
Ariela The Owners -- Arthur Anor
ASM Brescia v -- ATB Norte v OHMI - Bricocenter Italia BRICO CENTER Intellectual property French Text  EUECJ T-
ATB Norte v OHMI - Bricocenter Italia BRICO CENTER Intellectual property French Text  EUECJ T- -- Att Gen v McLaughlin
Att Gen v McLean -- Attorney-Generals Reference No
Attorney-Generals Reference No -- Avon Estates London
Avon Estates Ltd -- Azienda Agricola Silverfunghi
Azienda Agricola Tre -- Azzurro Trade Mark
B v Cager -- B -v- Refugee Appeals Tribunal Anor  IEHC 
B -v- Refugee Appeals Tribunal Anor  IEHC  -- Bailie Gartshore v Elizabeth
Bailie Gartshore v Sir -- Balfour v Scot
Balfour v Smith -- Bank of Ireland Mortgage Bank -v- Coleman 
Bank of Ireland Mortgage Bank -v- Coleman Pa -- Barclays Bank Plc -v-
Barclays Bank Plc v -- Barrett v Dickson
Barrett v Dickson -- Bastion Offshore Trust
Bastionspark LLP -- BBC Decision Notice  UKICO FS
BBC Decision Notice  UKICO FS -- Beaton of Kilconquhar
Beaton v Scot -- BEKIR OZDEMIR v
BEKIR YILDIZ v -- Benchwark Distribution Ltd
BENCIVENGA AND OTHERS -- Bernard Barbe v
Bernard Bareyt -- BG R On
BG Re Judicial -- Bimola Soondari Chowdhrani
Bimotor Taxation -- BISTA v POLAND
Bistern Estate Trust -- Blake v Harding
Blake v KMR -- BNP Paribas Personal Finance Consumer protection - Unfair terms in consumer contracts - Judgment  EUECJ C-
BNP Paribas Personal Finance Consumer protection - Unfair terms in consumer contracts - Judgment  EUECJ C- -- BONDAR AND OTHERS v RUSSIA
BONDAR AND OTHERS v UKRAINE -- Botham v Ministry
Botham v Niazi -- Boyle v Commission Fisheries policy  EUECJ T-
Boyle v Commission Fisheries policy  EUECJ T- -- Branch v McEvoy
Branchett v Stroud -- Brian and Rita
Brian Andrew Hughes -- British Airways v
British Airways European -- Broderick v Revenue
Brodie Ors -- Brown v Ministry Of
Brown v Ministry of -- Bryant Homes Scotland
Bryant Homtes Scotland -- BUJ v CROATIA
Bujac against Romania -- Burnet v Vietch
Burnets Tenants of -- Button Ors
Button v Salama -- BZNS Edinen v
C v B -- C v V
C -v- AG -- Cabinet Office v Information Commissioner Dismissed Freedom of Information Act  
Cabinet Office v Information Commissioner Dismissed Freedom of Information Act   -- Caledonian Insurance Co
Caledonian Insurance Co -- Cameron-Head v Cameron
Cameron-Head v Cameron -- CANADY v SLOVAKIA
CANAI Trade Mark -- CAPUANO v ITALY
Capuano v Revenue -- Carmona v R
Carmont and Another -- Cascades v Commission
Cascades SA v -- Catlin Syndicate Ltd
CECCHI v ITALY -- CG v Facebook Ireland Ltd Anor  NIQB 
CG v Facebook Ireland Ltd Anor  NIQB  -- Character World v
CHARAHILI v TURKEY -- Cheang Kok Sang
Cheang Thye Phin -- Chief Adjudication Officer v
Chief Adjudication Officer v -- Choudhry Anor
Choudhry Ors -- CIBA Freedom of establishment 
CIBA Freedom of establishment  -- City Technology Ltd
City Television v -- Clarke v Luton
Clarke v MacKenzie -- Clingham R on
Clingham v Royal -- Cochrane v Cochrane
Cochrane v David -- College of Ripon York St John v Hobbs 
College of Ripon York St John v Hobbs  -- Commerzbank Ag v
Commerzbank AG v -- Commission v France Transport 
Commission v France Transport  -- Commission v Luxembourg Approximation of laws
Commission v Luxembourg Approximation of laws -- Commission of the European Communities v Italian Republic Member States  EUECJ C-
Commission of the European Communities v Italian Republic Member States  EUECJ C- -- Commission v Sweden Judgment 
Commission v Sweden Judgment French -- Competition James Corrie
Competition James Grant -- Consort Lodge 
Consortium Commercial Developments -- Cooper v Royal
Cooper Scott v -- Corporate Oil and
Corporate Services Group -- Countess of Rothes v
Countess of Rothes v -- CQN RTM Co
CR v - -- Creditors of Cave v Murray  
Creditors of Cave v Murray   -- Criminal proceedings against Marc
Criminal proceedings against Mario -- Crown Prosecution Service Police and criminal justice  
Crown Prosecution Service Police and criminal justice   -- Cumbria County Council v Dow
Cumbria County Council v IC -- Customs Excise v St
Customs Excise v Total -- Czyzyk v Regional
Dadourian Group International Inc Ors v Simms Ors  -- Danbywiske anor
Dance Dance Dance -- Das v Revenue
Das v Roy -- David Sutherland of
David Swinburne v -- Day Anor v Day
Day Anor v Hosebay -- de Stefano v
DE suicide psychiatric -- DELMONTE AND BADANO
DELNICKA STRANA AND -- Department for Communities and Local Government Decision Notice  UKICO FER
Department for Communities and Local Government Decision Notice  UKICO FS -- Department for Work and Pensions Central government   UKICO FS
Department for Work and Pensions Central government   UKICO FS -- Derbyshire County Council v AC
Derbyshire County Council v Danby -- DEVICE ONLY MARK
Device Only Mark -- Diabain Live a
DIABECON Trade Mark -- DIMITROV AND MOMIN
DIMITROV AND OTHERS -- Director of Public Prosecutions v
Director of Public Prosecutions v -- Director of Public Prosecutions -v- Harford
Director of Public Prosecutions -v- Harris -- Dishington v L
Dishington v Lady -- Doctor Borthwick v
Doctor Brisbane v -- Doncaster Metropolitan Borough Council Undertakings
Doncaster Metropolitan Borough Council v -- DOUGLAS v Birmingham
Douglas v Bishop -- DPP v Finn 
DPP v Finn  -- Dr Donald Reid and North
Dr Donald Reid and South -- Dreessen Freedom of
Drelaud v Humble -- Dublin Waterworld Ltd
Dublin Waterworld Ltd -- DUMITRESCU AND OTHERS
DUMITRU AND OTHERS -- Duomo Gpa Freedom
Duomo Gpa French -- DZYRUK v POLAND
E v E -- EA  UKAITUR
EA  UKAITUR -- EA  UKAITUR
EA  UKAITUR -- EA  UKAITUR
EA  UKAITUR -- Earl of Wigton v Earl of Cassillis  Mor 
Earl of Wigton v Earl of Cassillis  Mor  -- eBay Inc v
eBay Patent  -- Edmond v Reid
Edmond v Robertson -- EGILL EINARSSON v ICELAND -
EGILL EINARSSON v ICELAND No -- Elevete Invest Group
Eley v Huntleigh -- ELMCROSS LIMITED IN
Elmdon Real Estates -- Energy Venture Partners
Energy Works Hull -- Equatorial Traders Ltd
E-Quattro Snc v -- ESQUIRE Trade Mark
ESR Insurance Services -- European Commission v Hellenic Republic Judgment of the Court Seventh
European Commission v Hellenic Republic Judgment of the Court Sixth -- EVOD Trade Mark
EVOLCEANU v ROMANIA -- EZZOUHDI v FRANCE
F v G -- Fairhurst v Northumberland
Fairhurst Ward Abbots -- Farrent v Customs
Farrer Anor -- Feeney anor
Feeney v Ging -- Ferris v Gerrard
Ferris v Glasgow -- Financial Services Authority FSA
Financial Services Authority v -- FIRSTOV v RUSSIA - 
FIRSTOV v RUSSIA -  -- Flat  
Flat   -- Flat  Maple
Flat  Mariners -- Flat  St
Flat  Clive -- Fletcher v Government
Fletcher v Grant -- Fonderie Officine Riunite
Fondmetal SPA v -- Foreign and Commonwealth Office v IC Freedom
Foreign and Commonwealth Office v IC The -- Fowles v Heathrow
Fowley v Conroy -- Franklin v Grampian
Franklin v Home -- Fried v Fried Approved 
Fried v Fried Approved  -- Furmedge Ors
Furnell v Flaherty -- FZO v Adams
G A -- Gair v Her
Gairden v Gairden -- Ganz v Childs Ors 
Ganz v Childs Ors  -- Gatoil International Inc
GATSALOVA v RUSSIA -- GEMINI FASHIONS Trade
Gemini Media Group -- George Campbell v
George Campbell Eldest -- GERDZHIKOV v BULGARIA
Gerecke ta West -- Gibraltar Betting 
Gibraltar Development Corporation -- Gilmour and others
Gilmour v Bank -- Glass v Laughlin
Glass v Magistrates -- GM Global Technology
GM v HM -- Golligher R v
Gollins v Gollins -- Gordon Place v
GORDON v PROCURATOR -- Gow v Harker
Gow v Henry -- Grant Anor
Grant Cutler -- Greater London Authority v
Greater London Authority Local -- Gregorio Valero Jordana
GREGORIOU v CYPRUS -- Ground Floor Flat
Ground Floor Flat -- Guildford Borough Council Decision Notice 
Guildford Borough Council Decision Notice  -- Gwyn v Citron
Gwyn Thomas v -- Gzimaila v Prosecutor
H v R -- Habte v Minister for Justice and Equality Ors  IECA 
Habte v Minister for Justice and Equality Ors  IECA  -- Halket  Mor
Halket and Wedderburn -- Hamilton v Lady
Hamilton v Lamb -- Hannigan v Cable Wireless Communications Plc 
Hannigan v Cable Wireless Communications Plc  -- Harlow Milner Ltd v Teasdale  EWHC 
Harlow Milner Ltd v Teasdale  EWHC  -- Hartley Anor
Hartley Ors -- Havering London Borough Council Local government 
Havering London Borough Council Local government  -- Health Case
Health Safety -- Helden v Strathmore
HELDENBURG v THE -- Henri Labeyrie v
Henri Lincoln and -- Herbertson v Thomas
Herbillon v Commission -- HG Construction Ltd
HG Copeman v -- Hill v Turner Anor ta
Hill v Turner Anor ta -- HM Attorney General v
HM Attorney General for -- Hochstrasser H M
Hochtief Linde-Kca-Dresden -- Holy Ghost Trade
holy hearts Trade -- Home Office v Morris
Home Office v Pledger -- Hosanna Arathoon Kerakoose
Hose Express Thurrock -- Hoyte R on
Hubbard Ors -- Humphreys v Environment
Humphreys v Environment -- Hussain v Turner
IM  -- In re Booth No   
In re Booth No    -- In the matter of C  JCA
In the matter of C  JRC -- Incorporation of Cordiners in
Incorporation of Cordiners of -- Inivos and Inivos
Inizan Freedom to -- Intellectual Property Office Decision Notice 
Intellectual Property Office Decision Notice  -- IPTEH SA AND
Ipulse IP Ltd -- Isaac John Campbell
Isaac Manasseh Meyer -- Item Industrietechnik v
Item Software UK -- IZZO v ITALY
J - v -- JA v WA
JA Young Leicester -- JAKOVLJEVIC AND OTHERS
Jakowlew v Nestor -- James Gordon v William Bogle  Hailes
James Gordon v William Bogle  Mor -- James Spencer v
James Steedman Merchant -- Janvey v Wastell
Janvrin v De -- Jean v Murfitt  JLRNote b
Jean v Murfitt  JLRNote c -- JFSC v Mathew
JFSC -v- AP -- Johal v Adams
Johal v Commission -- John Forbes in
John Forbes of -- John Morrison and Others - Spanki
John Morrison and Others - Stuart -- Johnson Control Systems
Johnson Controls Ltd -- Jones v Customs
Jones v Cutting -- Josiya Ors
Joslyn Anor -- JT Legal Guardian
JT v Leicester -- JZ Procedure Adjudicators
K v H -- KAGGOS v GREECE
KAGIA v GREECE -- KARAKAS AND BAYIR
KARAKAS AND OTHERS -- Kavanagh Anor
Kavanagh Anor -- Keiller v Mackenzie
KEIPENVARDECAS against Latvia -- KENNEDY AS AN
Kennedy v Ashfield -- Kernohan v Revenue
Kernohan v Galgorm -- Khan Application for
Khan v Armaguard -- Killiney Management SC
Killiney SC Management -- Kink Central Trade
Kinkedin Trade Mark -- KK v Secretary
KK v Sheffield -- KOCAMAN v TURKEY
Koceku R on -- KOSE v TURKEY
Kosenko Re Judicial -- Krohn Schroder
Krohn v Director -- Kurt Weighardt v
Kurtaj R on -- KZ v Commission
L Anor -- La Nautique Bar
La Nithisdale v -- Lafarge Aggregates Ltd
Lafarge Aggregates Ltd -- Lamb v Anderson
Lamb v Blackburn -- Lang v Lang  SLR 
Lang v Lang  SLR  -- Laurent Gbagbo v
Laurent v Lord -- LC v Secretary of State for Work and Pensions ESA
LC v Secretary of State for Work and Pensions PIP -- Leeds City Council Decision Notice  UKICO FS
Leeds City Council Decision Notice  UKICO FS -- Lemmens Approximation of
Lemmens v Barbara -- Levinson v Pickfords
Levinson Valuation Officer -- Lidl Judgment 
Lidl Ltd v -- Linfoot v Secretary
Linfor Limited v -- Livingstone v Rawyards
Livingstone v Revenue -- Lockharts Trustees v
Lockheed Martin Corp -- London Borough of
London Borough Of -- London Borough of
London Borough Of -- Lord Balmerino v Forrester
Lord Balmerino v Hamilton -- LOSEVSKIY AND OTHERS
LOSHENKO v UKRAINE -- Lubrizol Corporation 
Lubrizol France v -- LW v Secretary
LWANGA SEMPUNGO -- LZ v Slovakia
M v B -- M v Secretary of State for the Home Department Afghanistan
M v Secretary of State for the Home Department Algeria -- Macartney R v
Macartney UK Ltd -- Mackew v Moore
Mackey v Crawford -- Maduro Board of
Mady v Government -- Maher v Town
Maher -v- Governor -- Malcolm v Louttit
Malcolm v MacKenzie -- MAndrew v Reid
MANDRIGELYA v RUSSIA -- Marclean Technologies Judgment
Marclean Technologies Social -- Marine Terminals Ltd 
Marine Terminals Ltd -v- -- Marriott Worldwide v EUIPO - AC
Marriott Worldwide v EUIPO - Graf -- Martland v The
Martlet Estate Agents -- MATEESCU v ROMANIA -  -
MATEESCU v ROMANIA -  Communicated -- Maximum Play v
Maximus Networks Ltd -- Mc Garvey a
Mc George OF -- McCann v Vector
McCannv C -- McCullagh v Provident
McCullim Ors -- McGeough Re Judicial
McGeough v Thomson -- McKenna v An
McKenna Breen Ltd -- McMenamin v Harvest
McMenamin v LW -- MDonald v -
MDonald v a -- Mehari R on
Mehdi v Bates -- Menta y Limon
MENTAKOS v GREECE -- Messrs Peters Bogle
Messrs Pewtress and -- MGD -v- The
MGee v Anderson -- Michele Giubilini v
Michele Hill-Perkins v -- Miettinen v Council
Mietz Judgments ConventionEnforcement -- Miller v Stewart
Miller v Stewart -- Minister for Justice and Equality -v- DF
Minister for Justice and Equality -v- Doyle -- Ministry of Justice Central government   UKICO FS
Ministry of Justice Central government   UKICO FS -- MIRIVAIR Trade Mark
Mirjana DOBNIK and -- Miss A Stuart
Miss A Stupar -- Miss C Richardson v Mosaic
Miss C Richardson v Norfolk -- Miss E Omorogbe
Miss E Otamere -- Miss J Boyle
Miss J Bradburn -- Miss K Griffiths
Miss K Grimes -- Miss L Painter
Miss L Paris -- Miss N Alhuneidi
Miss N Ali -- Miss R Lockyer
Miss R Lowe -- Miss S Randall
Miss S Rankin -- Mitchell v Baird
Mitchell v Baird -- MKimmies Trustees v
MKinlay v Campbell -- Moat v North
Moat Ventures Ltd -- Moloney v Bolger
Moloney v Cashel -- Mooney v Police
Mooney R v -- Morison and Others
Morison Bayns and -- Motcombe Court Bedford Avenue - Rother Midland Birmingham Appointment
Motcombe Court Bedford Avenue - Rother Midland Birmingham Variation -- Mr A and Adelaide
Mr A and Beaumont -- Mr A Garratt
Mr A Garside -- Mr A McDonald v Shopfitting
Mr A McDonald v Wolseley -- Mr A Stott
Mr A Strong -- Mr and Mrs J
Mr and Mrs Jikiemi -- Mr B Mahmud
Mr B Mai -- Mr C Chambers
Mr C Chaplin -- Mr C Pierce
Mr C Pinder -- Mr D Anglin
Mr D Anson -- Mr D Hodgkiss
Mr D Hodgson -- Mr D Ramsay
Mr D Randerson -- Mr David Telford and North Ayrshire Council Section
Mr David Telford and North Ayrshire Council Whether -- Mr F Ardesi
Mr F Armosh -- Mr G Haughton
Mr G Hawley -- Mr George Green
Mr George Haliburton -- Mr I Eusebe
Mr I Evans -- Mr J Broad
Mr J Broadhead -- Mr J Hemphill
Mr J Henderson -- Mr J Pavilonis
Mr J Pawsey -- Mr James Clarke
Mr James Cochran -- Mr K Bibby
Mr K Biring -- Mr K Tudor-Rosa
Mr K Tullett -- Mr L Oszak
Mr L Otter -- Mr M Brown and
Mr M Brown v -- Mr M Hofton
Mr M Hoggart -- Mr M V
Mr M Patel -- Mr M Wodecki
Mr M Wojnach -- Mr N Cripps
Mr N Cross -- Mr O Alvarez
Mr O and -- Mr P Flaherty
Mr P Flanagan -- Mr P Shivarajan
Mr P Shone -- Mr Q Qu
Mr Q Saddique -- Mr R Huard
Mr R Hubbard -- Mr R Szymanski
Mr R Taha -- Mr S B Lively
Mr S B Reader -- Mr S Heesom
Mr S Hegarty -- Mr S Pope
Mr S Pottackal -- Mr SR Nunn
MR Sri Lanka -- Mr T Phillips-Noel
Mr T Pickin -- Mr W Madden
Mr W Maguire -- Mr X and Mayo
Mr X and Mayo -- Mr Y and
Mr Y and -- Mrs A Masson
Mrs A Mathew -- Mrs C Burr
Mrs C Burton -- Mrs D Fox
Mrs D Fulker -- Mrs F Gbadamosi
Mrs F Gillott -- Mrs I Telfer
Mrs I Templeton -- Mrs J Roldaan
Mrs J Rook -- Mrs K Smith v Layton
Mrs K Smith v London -- Mrs L Union-McGibbon
Mrs L Unsworth -- Mrs M Sweeney
Mrs M Sykes -- Mrs P Shepherd
Mrs P Shergill -- Mrs S Hall v NCC
Mrs S Hall v Royal -- Mrs T Gerrard
Mrs T Gillions -- Ms A Holden
Ms A Housley -- Ms C Cattell v Dr Rachael Sullivan Ta St Peter-s Avenue Dental Practice England and Wales Disability Discrimination 
Ms C Cattell v Dr Rachael Sullivan Ta St Peter-s Avenue Dental Practice England and Wales Disability Discrimination  -- Ms D Roscorla
Ms D Rowe -- Ms G Simpson v AMScreen
Ms G Simpson v Mr -- Ms J McKay
Ms J McKeown -- Ms Kirstin Scott
Ms Kirsty Marshall -- Ms M Hays
Ms M Hazeldine -- Ms O Aylmer
Ms O Cresswell -- Ms S Clark v GMS
Ms S Clark v Peter -- Ms T Bheka
Ms T Bibi -- Ms Y and Department
Ms Y and Dun -- Mulgrew v Stopwatch
Mulhaire -v- An -- Multiple cases with citation  Mor 
Multiple cases with citation  Mor  -- Multiple cases with citation  Mor 
Multiple cases with citation  Mor  -- Multiple cases with citation   Brn 
Multiple cases with citation   Brn  -- Multiple cases with citation   Elchies 
Multiple cases with citation   Elchies  -- Multiple cases with citation  Mor 
Multiple cases with citation  Mor  -- Murphy v Wicklow County Council  IEHC 
Murphy v Wicklow County Council  IEHC  -- Mustabshara Begum v
Mustafa Anor -- MZT LEARNICA AD
N Anor -- Nalan Uktu The
NALBANDYAN v ARMENIA -- National Association Of
National Audit Office -- Nayif v High
Nayif v The -- Nelson v Vara
Nelson v Westport -- Newell and Others
Newell v Holywood -- NI Bangladesh 
Ni Bheolain v -- Nima SARL v
Nimako-Boateng residence orders -- Nolan v Hartleys
Nolan v HM -- North Norfolk District
North Norfolk Planning -- Norwich Union Life Insurance Society v
Norwich Union Life Insurance Society v -- Nuisance Call Blocker
NUKA COLA Trade -- NZXT Trade Mark
O A -- OA  UKAITUR
OB AGAINST A -- Octavio Hernandez v
OCTET Trade Mark -- Ofrasio R v
OFriel v DPP -- Old Estates Limited
Old Ford Housing -- OMI Facilities Ltd
OMI MANAGEMENT LTD -- OPTI HEALTH Trade
Optical Express Gyle -- Orwell Park Management
Orwell v Salford -- Overture Services Inc Patent  UKIntelP o
Overture Services Inc Patent  UKIntelP o -- OZYOL v TURKEY
PACE AND OTHERS -- PANEL ON TAKEOVERS
Panellinios Sindesmos Viomikhanion -- Parkinson Engineering Services
Parkinson v Fawdon -- Patel v singh
Patel v Solicitors -- Paul Bahr v
Paul Baldwin TA -- Pearce Anor
Pearce High -- Pennicuik Chirurgeon v
Penniland and his -- Perth and Kinross
Perth City Wall -- Petrie v Lithgow
Petrie v Paul -- Phillips Anor v McGregor-Paterson
Phillips Anor v Messrs -- Pine Grove Investments
Pine v Law -- Planned Maintenance Engineering
Planning Environment -- Poland v Council
Poland v KS -- Porin kaupunki Judgment
Porlakur Orn BERGSSON -- POWERFUEL Trade Mark
Powergen Plc R -- Price v Elf
Price Free movement -- Procurator-Fiscal of Paisley
Procurator-Fiscal of the -- PS v HF 
PS v HF and -- Pyntek v Secretary
Pyotr Lamanovs -- PZD Trade Mark
Q v Q -- Quinn Insurance Ltd 
Quinn Insurance Ltd in -- Q-ZAR Trade Mark
R v R -- R v Secretary
R v Secretary -- Rahim Grays Tuition
Rahim R v -- Ram Chunder Dutt v Jughesh
Ram Chunder Dutt v Pearee -- Raphael de Dapper and others v European Parliament 
Raphael de Dapper and others v European Parliament  -- RC v Secretary of State for Defence
RC v Secretary of State for Work -- Redbridge London Borough Council Local government Borough council  UKICO FS
Redbridge London Borough Council Local government Borough council  UKICO FS -- Reid v Elmcrest
Reid Englishman v -- Representation of Beazley
Representation of Bedell -- Revenue and Customs v Charman
Revenue and Customs v Christian -- RIBBLE VALLEY COACHES
RIBCHEVA AND OTHERS -- Riggall Ors v Global Shipping Services Ltd  UKEAT 
Riggall Ors v Global Shipping Services Ltd  UKEAT  -- RMB Contractors Ltd
RMC Anor -- ROBERT McBRIDE v
Robert McGregor -- Robertson R on
Robertson Re Order -- RODRIGUES COELHO OSORIO
Rodrigues v Co-Operative -- Ropemaker Properties Ltd
Roper Anor -- ROUGHNECK Trade Mark
Roughton v Weston -- Royal Mail Education Other  UKICO FS
Royal Mail Education Other  UKICO FS -- Rubinstein and LOreal v OHIM Appeal  EUECJ C-P 
Rubinstein and LOreal v OHIM Appeal  EUECJ C-P  -- RW Concessions Ltd
RW v HM -- Rzekec v Younger
S A -- S Exclusion 
S v The -- Sahyouni area of
Sahyouni Order  -- Same Parties 
Same Parties  -- SANTELLI v FRANCE
Santen Approximation of -- SAVILLS PLC v
Savills UK Ltd -- Schindler Holding and
Schindler Holding Ltd -- Scott v Johnston
Scott v Kalning -- Seabridge Anor
Seabrokers Ltd v -- Secretary of State for the Home Department v Kamara
Secretary of State for the Home Department v KD -- Segal v Rutherfords
Segalov R on -- Sergio Del Plato
SERGIO FERRARI v -- Shah v London Borough Of Brent
Shah v London Borough Of Hounslow -- Shaw Education Trust Education  UKICO fs
Shaw Education Trust Education  UKICO fs -- SHER AND OTHERS v THE UNITED KINGDOM -  -
SHER AND OTHERS v THE UNITED KINGDOM -  Judgment -- Shrewsbury Atcham Borough Council 
Shrewsbury Atcham Borough Council v -- Sim v Donaldson  Mor 
Sim v Donaldson  Mor  -- Sindy Nagra Prosecutions
sine Trade Mark -- Sir Henry Home v Tenants of Kello and Sir Alexander Home 
Sir Henry Home v Tenants of Kello and Sir Alexander Home  -- Sir William Ballantyne
Sir William Ballenden -- Skinner v Hi-Miles
Skinner v IC -- SM v Secretary of State for Work and Pensions PIP
SM v Secretary of State for Work and Pensions SPC -- Smith or Baird
Smith v Osborne -- Snell v Revenue Customs 
Snell v Revenue Customs EXCISE -- Solberg v EMCDDA
SOLCAN v ROMANIA -- SOU Nigeria v
Souaissi v  -- Southwark Carers v
Southwark Council Decision -- Special case -
Special Case - -- Sprott v Ross
Sproul v MCusker -- St Johns Church
St Johns Church -- STANISZEWSKI v POLAND
Staniszewski v Revenue -- Steele v Technical
Steele v The -- Stevensdrake Ltd v
Stevensdrake Ltd ta -- Stirling v Keir
Stirling v Laurie -- Strang and Ors v de Bourbon des Deux Siciles 
Strang and Ors v de Bourbon des Deux Siciles -Apr- -- Suede API et Commission Law governing the institutions  EUECJ C-
Suede API et Commission Law governing the institutions  EUECJ C- -- Suraj Bunsi Koer
Surana Re Land -- Swain v Geoffrey
Swain v Hillman -- Symmons R v
Symon v Macdonald -- SZYSZKOWSKI v SAN
T -  -- Tait v White
Taite Anor -- TASKIN v TURKEY
Taskiran v The -- TC Kenya v
TC Kirton Plant -- Temple Security Services Ltd v Chay 
Temple Security Services Ltd v Chay  -- TGE Gas Engineering Opinion
The Applicant and Scottish Courts and Tribunals Service  ScotIC  -- The BSS Group
The BT Pension -- The Competition And
The Competition and -- The Earl of Annandale v The Earl
The Earl of Annandale v The Tenants -- The Goldman Sachs
The Goldsmiths of -- The Kings Arms
The Kings College -- The Lord Livingston
The Lord Lovat -- The National Guild of Removers Storers Ltd v Central
The National Guild of Removers Storers Ltd v Bee -- The Queen v
The Queen v -- The Serious Organised Crime Agency v Namli
The Serious Organised Crime Agency v Robb -- The Wellcome Trust v Revenue
The Wellcome Trust v The -- Thomas Laurie Collector
Thomas Laury v -- Thomson v Govan
Thomson v Greenock -- Tilson v New
Tim Arrow -- Todd v First
Todd Liquidator of -- Torney Re Judicial
Toronto Railway Company -- Tradition Securities 
Tradition Securities and -- TRETIAK v UKRAINE
TRETOLA v ITALY -- Tsakouridis European citizenship  EUECJ C- 
Tsakouridis European citizenship  EUECJ C-  -- Turner v Phythian
Turner v Pilotage -- Tzu-Tsai Cheng v
U Anor -- ULTRASTORE RAPID GE
Ultrasun v EUIPO -- United Utilities Plc
United Utilities Plc -- Uppal v Revenue
Uppal ta Chauffeuring -- UZZO v ITALY
v  JCA -- VA  UKAITUR
VALANCIENE v LITHUANIA -- VARINBDER KUMAR SOOD
Vario Tek Judgment -- Veitch v Executors
Veitch v Horsburgh -- ViaSat v Commission Access to documents - Document
ViaSat v Commission Access to documents - Mobile -- Viridian Power v
Viridian Power Ltd -- Volaw v Tax Comptroller   JLR 
W Z  -- Waite v Waite  EWCA Civ 
Waite v Waite  EWCA Civ  -- Wallis v Learonal
Wallis Ltd v -- Ward ta WPS
Ward v The -- Watson v Grants
Watson v Greater -- Wedderburn v Durie 
Wedderburn v Durie  -- West Bromwich Albion
West Bromwich Building -- Westpoint Portishead Management
Westport Developments Ltd -- Whiteknights Consultants Ltd
Whiteland Import Export -- Wilkinson v Fitzgerald
Wilkinson v Kitzinger -- William Irvine Merchant
William J and -- Williams v Gray
Williams v Green -- Wilson v Nicolson
Wilson v Nightingale -- Wirral Metropolitan Borough Council Local government Borough council 
Wirral Metropolitan Borough Council Local government Borough council  -- Wood v De
Wood v Director -- Wrexham County Borough Council v Berry 
Wrexham County Borough Council v Berry  -- WZ v POLAND
X Anor -- XC and Others
XC v Commission -- XZ Russia 
Y Anor -- YETER v TURKEY
Yetis v Revenue -- Youssif v Jordan
Yousuf R on -- YZ v Secretary
Z v University -- Zdzislaw LESKIEWICZ v
Zdzislaw STENKA v -- Zubair EEA regs
Zubair v Revenue -- ZZZZZ Trade Mark Opposition  UKIntelP o  March 